//MAP CONVERTED BY dmm2tgm.py THIS HEADER COMMENT PREVENTS RECONVERSION, DO NOT REMOVE
"a" = (
/obj/structure/spacevine{
	icon = 'icons/effects/effects.dmi';
	icon_state = "smoke";
	name = "steam";
	plane = -2
	},
/obj/structure/spacevine{
	icon = 'icons/effects/effects.dmi';
	icon_state = "smoke";
	name = "steam";
	pixel_x = 19;
	plane = -2
	},
/obj/structure/spacevine{
	icon = 'icons/effects/effects.dmi';
	icon_state = "smoke";
	name = "steam";
	pixel_y = 12;
	pixel_x = 17;
	plane = -2
	},
/obj/effect/overlay/fog/fog2{
	plane = -2
	},
/turf/open/indestructible/ground/outside/water{
	name = "hot spring";
	color = "#90DBFE";
	light_range = 2;
	light_power = 2;
	light_color = "#BAF8FF"
	},
/area/f13/wasteland)
"b" = (
/obj/structure/spacevine{
	icon = 'icons/effects/effects.dmi';
	icon_state = "smoke";
	name = "steam";
	plane = -2
	},
/obj/structure/spacevine{
	icon = 'icons/effects/effects.dmi';
	icon_state = "smoke";
	name = "steam";
	pixel_y = 16;
	plane = -2
	},
/obj/effect/decal/cleanable/glitter/pink,
/obj/effect/overlay/fog/fog2{
	plane = -2
	},
/turf/open/indestructible/ground/outside/water{
	name = "hot spring";
	color = "#90DBFE";
	light_range = 2;
	light_power = 2;
	light_color = "#BAF8FF"
	},
/area/f13/wasteland)
"d" = (
/obj/structure/spacevine{
	icon = 'icons/effects/effects.dmi';
	icon_state = "smoke";
	name = "steam";
	plane = -2
	},
/obj/structure/spacevine{
	icon = 'icons/effects/effects.dmi';
	icon_state = "smoke";
	name = "steam";
	pixel_y = 16;
	plane = -2
	},
/obj/structure/spacevine{
	icon = 'icons/effects/effects.dmi';
	icon_state = "smoke";
	name = "steam";
	pixel_x = 19;
	plane = -2
	},
/obj/structure/chair/bench{
	dir = 1;
	plane = -6
	},
/obj/effect/overlay/fog/fog2{
	plane = -2
	},
/turf/open/indestructible/ground/outside/water{
	name = "hot spring";
	color = "#90DBFE";
	light_range = 2;
	light_power = 2;
	light_color = "#BAF8FF"
	},
/area/f13/wasteland)
"f" = (
/obj/structure/spacevine{
	icon = 'icons/effects/effects.dmi';
	icon_state = "smoke";
	name = "steam";
	plane = -2
	},
/obj/structure/spacevine{
	icon = 'icons/effects/effects.dmi';
	icon_state = "smoke";
	name = "steam";
	pixel_y = 16;
	plane = -2
	},
/obj/structure/spacevine{
	icon = 'icons/effects/effects.dmi';
	icon_state = "smoke";
	name = "steam";
	pixel_x = 19;
	plane = -2
	},
/obj/structure/chair/bench{
	dir = 8;
	plane = -6
	},
/obj/effect/overlay/fog/fog2{
	plane = -2
	},
/obj/effect/sound_emitter/foxybar/hottub,
/turf/open/indestructible/ground/outside/water{
	name = "hot spring";
	color = "#90DBFE";
	light_range = 2;
	light_power = 2;
	light_color = "#BAF8FF"
	},
/area/f13/wasteland)
"g" = (
/obj/structure/spacevine{
	icon = 'icons/effects/effects.dmi';
	icon_state = "smoke";
	name = "steam";
	pixel_y = 16;
	plane = -2
	},
/obj/structure/spacevine{
	icon = 'icons/effects/effects.dmi';
	icon_state = "smoke";
	name = "steam";
	pixel_x = 19;
	plane = -2
	},
/obj/structure/spacevine{
	icon = 'icons/effects/effects.dmi';
	icon_state = "smoke";
	name = "steam";
	pixel_y = 12;
	pixel_x = 17;
	plane = -2
	},
/obj/structure/chair/bench{
	dir = 8;
	plane = -6
	},
/obj/effect/decal/cleanable/glitter/pink,
/obj/effect/overlay/fog/fog2{
	plane = -2
	},
/turf/open/indestructible/ground/outside/water{
	name = "hot spring";
	color = "#90DBFE";
	light_range = 2;
	light_power = 2;
	light_color = "#BAF8FF"
	},
/area/f13/wasteland)
"j" = (
/obj/structure/spacevine{
	icon = 'icons/effects/effects.dmi';
	icon_state = "smoke";
	name = "steam";
	plane = -2
	},
/obj/structure/spacevine{
	icon = 'icons/effects/effects.dmi';
	icon_state = "smoke";
	name = "steam";
	pixel_y = 16;
	plane = -2
	},
/obj/effect/overlay/fog/fog2{
	plane = -2
	},
/turf/open/indestructible/ground/outside/water{
	name = "hot spring";
	color = "#90DBFE";
	light_range = 2;
	light_power = 2;
	light_color = "#BAF8FF"
	},
/area/f13/wasteland)
"k" = (
/obj/structure/spacevine{
	icon = 'icons/effects/effects.dmi';
	icon_state = "smoke";
	name = "steam";
	pixel_y = 16;
	plane = -2
	},
/obj/structure/spacevine{
	icon = 'icons/effects/effects.dmi';
	icon_state = "smoke";
	name = "steam";
	pixel_x = 19;
	plane = -2
	},
/obj/effect/overlay/fog/fog2{
	plane = -2
	},
/turf/open/indestructible/ground/outside/water{
	name = "hot spring";
	color = "#90DBFE";
	light_range = 2;
	light_power = 2;
	light_color = "#BAF8FF"
	},
/area/f13/wasteland)
"l" = (
/obj/structure/chair/bench{
	plane = -6
	},
/obj/effect/decal/cleanable/glitter/pink,
/obj/effect/overlay/fog/fog2{
	plane = -2
	},
/turf/open/indestructible/ground/outside/water{
	name = "hot spring";
	color = "#90DBFE";
	light_range = 2;
	light_power = 2;
	light_color = "#BAF8FF"
	},
/area/f13/wasteland)
"n" = (
/obj/machinery/telecomms/relay/preset/auto,
/turf/open/floor/wood_common/wood_common_dark,
/area/f13/wasteland)
"p" = (
/obj/structure/spacevine{
	icon = 'icons/effects/effects.dmi';
	icon_state = "smoke";
	name = "steam";
	pixel_y = 16;
	plane = -2
	},
/obj/structure/spacevine{
	icon = 'icons/effects/effects.dmi';
	icon_state = "smoke";
	name = "steam";
	pixel_x = 19;
	plane = -2
	},
/obj/effect/decal/cleanable/glitter/blue{
	plane = -4;
	layer = 3
	},
/obj/effect/overlay/fog/fog2{
	plane = -2
	},
/obj/effect/sound_emitter/foxybar/hottub,
/turf/open/indestructible/ground/outside/water{
	name = "hot spring";
	color = "#90DBFE";
	light_range = 2;
	light_power = 2;
	light_color = "#BAF8FF"
	},
/area/f13/wasteland)
"q" = (
/obj/structure/spacevine{
	icon = 'icons/effects/effects.dmi';
	icon_state = "smoke";
	name = "steam";
	pixel_y = 16;
	plane = -2
	},
/obj/structure/spacevine{
	icon = 'icons/effects/effects.dmi';
	icon_state = "smoke";
	name = "steam";
	pixel_y = 12;
	pixel_x = 17;
	plane = -2
	},
/obj/effect/decal/cleanable/glitter/white,
/obj/effect/overlay/fog/fog2{
	plane = -2
	},
/turf/open/indestructible/ground/outside/water{
	name = "hot spring";
	color = "#90DBFE";
	light_range = 2;
	light_power = 2;
	light_color = "#BAF8FF"
	},
/area/f13/wasteland)
"r" = (
/obj/structure/spacevine{
	icon = 'icons/effects/effects.dmi';
	icon_state = "smoke";
	name = "steam";
	plane = -2
	},
/obj/structure/spacevine{
	icon = 'icons/effects/effects.dmi';
	icon_state = "smoke";
	name = "steam";
	pixel_y = 16;
	plane = -2
	},
/obj/structure/spacevine{
	icon = 'icons/effects/effects.dmi';
	icon_state = "smoke";
	name = "steam";
	pixel_x = 19;
	plane = -2
	},
/obj/structure/chair/bench{
	plane = -6
	},
/obj/effect/decal/cleanable/glitter/blue,
/obj/effect/overlay/fog/fog2{
	plane = -2
	},
/turf/open/indestructible/ground/outside/water{
	name = "hot spring";
	color = "#90DBFE";
	light_range = 2;
	light_power = 2;
	light_color = "#BAF8FF"
	},
/area/f13/wasteland)
"s" = (
/turf/open/space/bluespace,
/area/f13/wasteland)
"t" = (
/obj/effect/overlay/fog/fog2{
	plane = -2
	},
/turf/open/indestructible/ground/inside/mountain,
/area/f13/wasteland)
"u" = (
/obj/structure/spacevine{
	icon = 'icons/effects/effects.dmi';
	icon_state = "smoke";
	name = "steam";
	pixel_y = 16;
	plane = -2
	},
/obj/structure/spacevine{
	icon = 'icons/effects/effects.dmi';
	icon_state = "smoke";
	name = "steam";
	pixel_x = 19;
	plane = -2
	},
/obj/effect/decal/cleanable/glitter/white,
/obj/effect/overlay/fog/fog2{
	plane = -2
	},
/turf/open/indestructible/ground/outside/water{
	name = "hot spring";
	color = "#90DBFE";
	light_range = 2;
	light_power = 2;
	light_color = "#BAF8FF"
	},
/area/f13/wasteland)
"w" = (
/obj/structure/spacevine{
	icon = 'icons/effects/effects.dmi';
	icon_state = "smoke";
	name = "steam";
	pixel_y = 16;
	plane = -2
	},
/obj/structure/spacevine{
	icon = 'icons/effects/effects.dmi';
	icon_state = "smoke";
	name = "steam";
	pixel_y = 12;
	pixel_x = 17;
	plane = -2
	},
/obj/effect/overlay/fog/fog2{
	plane = -2
	},
/turf/open/indestructible/ground/outside/water{
	name = "hot spring";
	color = "#90DBFE";
	light_range = 2;
	light_power = 2;
	light_color = "#BAF8FF"
	},
/area/f13/wasteland)
"y" = (
/obj/structure/spacevine{
	icon = 'icons/effects/effects.dmi';
	icon_state = "smoke";
	name = "steam";
	plane = -2
	},
/obj/structure/spacevine{
	icon = 'icons/effects/effects.dmi';
	icon_state = "smoke";
	name = "steam";
	pixel_y = 16;
	plane = -2
	},
/obj/structure/spacevine{
	icon = 'icons/effects/effects.dmi';
	icon_state = "smoke";
	name = "steam";
	pixel_y = 12;
	pixel_x = 17;
	plane = -2
	},
/obj/effect/decal/cleanable/glitter/blue{
	plane = -4;
	layer = 3
	},
/obj/effect/overlay/fog/fog2{
	plane = -2
	},
/turf/open/indestructible/ground/outside/water{
	name = "hot spring";
	color = "#90DBFE";
	light_range = 2;
	light_power = 2;
	light_color = "#BAF8FF"
	},
/area/f13/wasteland)
"z" = (
/obj/structure/spacevine{
	icon = 'icons/effects/effects.dmi';
	icon_state = "smoke";
	name = "steam";
	pixel_y = 16;
	plane = -2
	},
/obj/structure/spacevine{
	icon = 'icons/effects/effects.dmi';
	icon_state = "smoke";
	name = "steam";
	pixel_x = 19;
	plane = -2
	},
/obj/effect/decal/cleanable/glitter/blue,
/obj/effect/overlay/fog/fog2{
	plane = -2
	},
/obj/effect/sound_emitter/foxybar/hottub,
/turf/open/indestructible/ground/outside/water{
	name = "hot spring";
	color = "#90DBFE";
	light_range = 2;
	light_power = 2;
	light_color = "#BAF8FF"
	},
/area/f13/wasteland)
"A" = (
/turf/closed/indestructible/f13/obsidian,
/area/f13/wasteland)
"B" = (
/obj/structure/spacevine{
	icon = 'icons/effects/effects.dmi';
	icon_state = "smoke";
	name = "steam";
	pixel_y = 16;
	plane = -2
	},
/obj/structure/spacevine{
	icon = 'icons/effects/effects.dmi';
	icon_state = "smoke";
	name = "steam";
	pixel_x = 19;
	plane = -2
	},
/obj/structure/spacevine{
	icon = 'icons/effects/effects.dmi';
	icon_state = "smoke";
	name = "steam";
	pixel_y = 12;
	pixel_x = 17;
	plane = -2
	},
/obj/structure/chair/bench{
	dir = 8;
	plane = -6
	},
/obj/effect/overlay/fog/fog2{
	plane = -2
	},
/turf/open/indestructible/ground/outside/water{
	name = "hot spring";
	color = "#90DBFE";
	light_range = 2;
	light_power = 2;
	light_color = "#BAF8FF"
	},
/area/f13/wasteland)
"C" = (
/obj/structure/spacevine{
	icon = 'icons/effects/effects.dmi';
	icon_state = "smoke";
	name = "steam";
	pixel_x = 19;
	plane = -2
	},
/obj/structure/spacevine{
	icon = 'icons/effects/effects.dmi';
	icon_state = "smoke";
	name = "steam";
	pixel_y = 12;
	pixel_x = 17;
	plane = -2
	},
/obj/effect/decal/cleanable/glitter/blue,
/obj/effect/overlay/fog/fog2{
	plane = -2
	},
/turf/open/indestructible/ground/outside/water{
	name = "hot spring";
	color = "#90DBFE";
	light_range = 2;
	light_power = 2;
	light_color = "#BAF8FF"
	},
/area/f13/wasteland)
"E" = (
/obj/effect/overlay/fog/fog2{
	plane = -2
	},
/turf/closed/indestructible/f13/obsidian,
/area/f13/wasteland)
"F" = (
/obj/structure/spacevine{
	icon = 'icons/effects/effects.dmi';
	icon_state = "smoke";
	name = "steam";
	pixel_y = 12;
	pixel_x = 17;
	plane = -2
	},
/obj/effect/overlay/fog/fog2{
	plane = -2
	},
/turf/open/indestructible/ground/outside/water{
	name = "hot spring";
	color = "#90DBFE";
	light_range = 2;
	light_power = 2;
	light_color = "#BAF8FF"
	},
/area/f13/wasteland)
"G" = (
/obj/structure/spacevine{
	icon = 'icons/effects/effects.dmi';
	icon_state = "smoke";
	name = "steam";
	plane = -2
	},
/obj/structure/spacevine{
	icon = 'icons/effects/effects.dmi';
	icon_state = "smoke";
	name = "steam";
	pixel_y = 16;
	plane = -2
	},
/obj/structure/spacevine{
	icon = 'icons/effects/effects.dmi';
	icon_state = "smoke";
	name = "steam";
	pixel_y = 12;
	pixel_x = 17;
	plane = -2
	},
/obj/effect/decal/cleanable/glitter/white,
/obj/effect/overlay/fog/fog2{
	plane = -2
	},
/turf/open/indestructible/ground/outside/water{
	name = "hot spring";
	color = "#90DBFE";
	light_range = 2;
	light_power = 2;
	light_color = "#BAF8FF"
	},
/area/f13/wasteland)
"I" = (
/obj/structure/spacevine{
	icon = 'icons/effects/effects.dmi';
	icon_state = "smoke";
	name = "steam";
	plane = -2
	},
/obj/structure/spacevine{
	icon = 'icons/effects/effects.dmi';
	icon_state = "smoke";
	name = "steam";
	pixel_y = 16;
	plane = -2
	},
/obj/structure/spacevine{
	icon = 'icons/effects/effects.dmi';
	icon_state = "smoke";
	name = "steam";
	pixel_x = 19;
	plane = -2
	},
/obj/structure/spacevine{
	icon = 'icons/effects/effects.dmi';
	icon_state = "smoke";
	name = "steam";
	pixel_y = 12;
	pixel_x = 17;
	plane = -2
	},
/obj/effect/overlay/fog/fog2{
	plane = -2
	},
/turf/open/indestructible/ground/outside/water{
	name = "hot spring";
	color = "#90DBFE";
	light_range = 2;
	light_power = 2;
	light_color = "#BAF8FF"
	},
/area/f13/wasteland)
"J" = (
/obj/structure/spacevine{
	icon = 'icons/effects/effects.dmi';
	icon_state = "smoke";
	name = "steam";
	plane = -2
	},
/obj/structure/spacevine{
	icon = 'icons/effects/effects.dmi';
	icon_state = "smoke";
	name = "steam";
	pixel_y = 16;
	plane = -2
	},
/obj/structure/spacevine{
	icon = 'icons/effects/effects.dmi';
	icon_state = "smoke";
	name = "steam";
	pixel_x = 19;
	plane = -2
	},
/obj/structure/chair/bench{
	dir = 1;
	plane = -6
	},
/obj/effect/decal/cleanable/glitter/pink,
/obj/effect/overlay/fog/fog2{
	plane = -2
	},
/turf/open/indestructible/ground/outside/water{
	name = "hot spring";
	color = "#90DBFE";
	light_range = 2;
	light_power = 2;
	light_color = "#BAF8FF"
	},
/area/f13/wasteland)
"K" = (
/obj/structure/spacevine{
	icon = 'icons/effects/effects.dmi';
	icon_state = "smoke";
	name = "steam";
	plane = -2
	},
/obj/structure/spacevine{
	icon = 'icons/effects/effects.dmi';
	icon_state = "smoke";
	name = "steam";
	pixel_y = 16;
	plane = -2
	},
/obj/structure/spacevine{
	icon = 'icons/effects/effects.dmi';
	icon_state = "smoke";
	name = "steam";
	pixel_x = 19;
	plane = -2
	},
/obj/structure/spacevine{
	icon = 'icons/effects/effects.dmi';
	icon_state = "smoke";
	name = "steam";
	pixel_y = 12;
	pixel_x = 17;
	plane = -2
	},
/obj/structure/chair/bench{
	dir = 1;
	plane = -6
	},
/obj/effect/overlay/fog/fog2{
	plane = -2
	},
/turf/open/indestructible/ground/outside/water{
	name = "hot spring";
	color = "#90DBFE";
	light_range = 2;
	light_power = 2;
	light_color = "#BAF8FF"
	},
/area/f13/wasteland)
"L" = (
/obj/structure/spacevine{
	icon = 'icons/effects/effects.dmi';
	icon_state = "smoke";
	name = "steam";
	plane = -2
	},
/obj/structure/spacevine{
	icon = 'icons/effects/effects.dmi';
	icon_state = "smoke";
	name = "steam";
	pixel_y = 12;
	pixel_x = 17;
	plane = -2
	},
/obj/effect/decal/cleanable/glitter/white,
/obj/effect/overlay/fog/fog2{
	plane = -2
	},
/turf/open/indestructible/ground/outside/water{
	name = "hot spring";
	color = "#90DBFE";
	light_range = 2;
	light_power = 2;
	light_color = "#BAF8FF"
	},
/area/f13/wasteland)
"M" = (
/obj/structure/spacevine{
	icon = 'icons/effects/effects.dmi';
	icon_state = "smoke";
	name = "steam";
	plane = -2
	},
/obj/structure/spacevine{
	icon = 'icons/effects/effects.dmi';
	icon_state = "smoke";
	name = "steam";
	pixel_y = 16;
	plane = -2
	},
/obj/structure/spacevine{
	icon = 'icons/effects/effects.dmi';
	icon_state = "smoke";
	name = "steam";
	pixel_x = 19;
	plane = -2
	},
/obj/structure/chair/bench{
	plane = -6
	},
/obj/effect/overlay/fog/fog2{
	plane = -2
	},
/turf/open/indestructible/ground/outside/water{
	name = "hot spring";
	color = "#90DBFE";
	light_range = 2;
	light_power = 2;
	light_color = "#BAF8FF"
	},
/area/f13/wasteland)
"N" = (
/obj/structure/spacevine{
	icon = 'icons/effects/effects.dmi';
	icon_state = "smoke";
	name = "steam";
	pixel_y = 16;
	plane = -2
	},
/obj/structure/spacevine{
	icon = 'icons/effects/effects.dmi';
	icon_state = "smoke";
	name = "steam";
	pixel_x = 19;
	plane = -2
	},
/obj/structure/spacevine{
	icon = 'icons/effects/effects.dmi';
	icon_state = "smoke";
	name = "steam";
	pixel_y = 12;
	pixel_x = 17;
	plane = -2
	},
/obj/structure/chair/bench{
	dir = 1;
	plane = -6
	},
/obj/effect/overlay/fog/fog2{
	plane = -2
	},
/turf/open/indestructible/ground/outside/water{
	name = "hot spring";
	color = "#90DBFE";
	light_range = 2;
	light_power = 2;
	light_color = "#BAF8FF"
	},
/area/f13/wasteland)
"O" = (
/obj/structure/spacevine{
	icon = 'icons/effects/effects.dmi';
	icon_state = "smoke";
	name = "steam";
	plane = -2
	},
/obj/structure/spacevine{
	icon = 'icons/effects/effects.dmi';
	icon_state = "smoke";
	name = "steam";
	pixel_y = 16;
	plane = -2
	},
/obj/structure/spacevine{
	icon = 'icons/effects/effects.dmi';
	icon_state = "smoke";
	name = "steam";
	pixel_x = 19;
	plane = -2
	},
/obj/structure/chair/bench{
	dir = 8;
	plane = -6
	},
/obj/effect/decal/cleanable/glitter/blue,
/obj/effect/overlay/fog/fog2{
	plane = -2
	},
/turf/open/indestructible/ground/outside/water{
	name = "hot spring";
	color = "#90DBFE";
	light_range = 2;
	light_power = 2;
	light_color = "#BAF8FF"
	},
/area/f13/wasteland)
"R" = (
/obj/effect/overlay/fog/fog2{
	plane = -2
	},
/obj/structure/glowshroom,
/turf/open/indestructible/ground/inside/mountain,
/area/f13/wasteland)
"S" = (
/obj/effect/turf_decal/siding/wideplating/dark{
	dir = 9
	},
/obj/effect/overlay/fog/fog2{
	plane = -2
	},
/obj/structure/railing{
	color = "#A47449";
	dir = 8
	},
/turf/open/indestructible/ground/inside/mountain,
/area/f13/wasteland)
"V" = (
/obj/structure/spacevine{
	icon = 'icons/effects/effects.dmi';
	icon_state = "smoke";
	name = "steam";
	pixel_y = 16;
	plane = -2
	},
/obj/structure/spacevine{
	icon = 'icons/effects/effects.dmi';
	icon_state = "smoke";
	name = "steam";
	pixel_x = 19;
	plane = -2
	},
/obj/structure/spacevine{
	icon = 'icons/effects/effects.dmi';
	icon_state = "smoke";
	name = "steam";
	pixel_y = 12;
	pixel_x = 17;
	plane = -2
	},
/obj/effect/decal/cleanable/glitter/pink,
/obj/effect/overlay/fog/fog2{
	plane = -2
	},
/turf/open/indestructible/ground/outside/water{
	name = "hot spring";
	color = "#90DBFE";
	light_range = 2;
	light_power = 2;
	light_color = "#BAF8FF"
	},
/area/f13/wasteland)
"W" = (
/obj/effect/overlay/fog/fog2{
	plane = -2
	},
/obj/structure/flora/wasteplant/fever_blossom,
/turf/open/indestructible/ground/inside/mountain,
/area/f13/wasteland)
"X" = (
/obj/structure/spacevine{
	icon = 'icons/effects/effects.dmi';
	icon_state = "smoke";
	name = "steam";
	plane = -2
	},
/obj/structure/spacevine{
	icon = 'icons/effects/effects.dmi';
	icon_state = "smoke";
	name = "steam";
	pixel_x = 19;
	plane = -2
	},
/obj/structure/spacevine{
	icon = 'icons/effects/effects.dmi';
	icon_state = "smoke";
	name = "steam";
	pixel_y = 12;
	pixel_x = 17;
	plane = -2
	},
/obj/effect/decal/cleanable/glitter/blue{
	plane = -4;
	layer = 3
	},
/obj/effect/overlay/fog/fog2{
	plane = -2
	},
/turf/open/indestructible/ground/outside/water{
	name = "hot spring";
	color = "#90DBFE";
	light_range = 2;
	light_power = 2;
	light_color = "#BAF8FF"
	},
/area/f13/wasteland)
"Y" = (
/obj/structure/spacevine{
	icon = 'icons/effects/effects.dmi';
	icon_state = "smoke";
	name = "steam";
	plane = -2
	},
/obj/structure/spacevine{
	icon = 'icons/effects/effects.dmi';
	icon_state = "smoke";
	name = "steam";
	pixel_x = 19;
	plane = -2
	},
/obj/structure/spacevine{
	icon = 'icons/effects/effects.dmi';
	icon_state = "smoke";
	name = "steam";
	pixel_y = 12;
	pixel_x = 17;
	plane = -2
	},
/obj/effect/decal/cleanable/glitter/white,
/obj/effect/sound_emitter/foxybar/hottub,
/obj/effect/fake_stairs/south{
	alpha = 30
	},
/obj/effect/overlay/fog/fog2{
	plane = -2
	},
/turf/open/indestructible/ground/outside/water{
	name = "hot spring";
	color = "#90DBFE";
	light_range = 2;
	light_power = 2;
	light_color = "#BAF8FF"
	},
/area/f13/wasteland)
"Z" = (
/obj/structure/spacevine{
	icon = 'icons/effects/effects.dmi';
	icon_state = "smoke";
	name = "steam";
	pixel_x = 19;
	plane = -2
	},
/obj/structure/spacevine{
	icon = 'icons/effects/effects.dmi';
	icon_state = "smoke";
	name = "steam";
	pixel_y = 12;
	pixel_x = 17;
	plane = -2
	},
/obj/structure/chair/bench{
	plane = -6
	},
/obj/effect/decal/cleanable/glitter/white,
/obj/effect/overlay/fog/fog2{
	plane = -2
	},
/turf/open/indestructible/ground/outside/water{
	name = "hot spring";
	color = "#90DBFE";
	light_range = 2;
	light_power = 2;
	light_color = "#BAF8FF"
	},
/area/f13/wasteland)

(1,1,1) = {"
s
s
s
s
n
E
E
E
E
E
E
E
E
E
E
E
"}
(2,1,1) = {"
s
s
s
s
s
E
E
E
A
E
B
O
g
f
E
E
"}
(3,1,1) = {"
s
s
s
s
s
E
t
t
A
d
p
q
F
X
M
E
"}
(4,1,1) = {"
s
s
s
s
s
E
W
t
A
N
L
V
u
w
Z
E
"}
(5,1,1) = {"
s
s
s
s
s
E
R
t
A
J
j
z
b
C
r
E
"}
(6,1,1) = {"
s
s
s
s
s
E
t
t
A
K
G
y
k
a
l
E
"}
(7,1,1) = {"
s
s
s
s
s
E
t
t
A
E
C
I
Y
S
E
E
"}
(8,1,1) = {"
s
s
s
s
s
E
t
t
t
t
t
t
t
R
E
E
"}
(9,1,1) = {"
s
s
s
s
s
E
t
R
R
t
t
W
t
t
E
E
"}
(10,1,1) = {"
s
s
s
s
s
E
E
E
E
E
E
E
E
E
E
E
"}
(11,1,1) = {"
s
s
s
s
s
s
s
s
s
s
s
s
s
s
s
s
"}
(12,1,1) = {"
s
s
s
s
s
s
s
s
s
s
s
s
s
s
s
s
"}
(13,1,1) = {"
s
s
s
s
s
s
s
s
s
s
s
s
s
s
s
s
"}
(14,1,1) = {"
s
s
s
s
s
s
s
s
s
s
s
s
s
s
s
s
"}
(15,1,1) = {"
s
s
s
s
s
s
s
s
s
s
s
s
s
s
s
s
"}
(16,1,1) = {"
s
s
s
s
s
s
s
s
s
s
s
s
s
s
s
s
"}
